tmxfile#lv00-lazerjail
sumax #1025
sdmax #511
slmax #767
srmax #769
maxcel#11,11
0,0#F,F,F,F,NULL
1,0#F,F,F,F,NULL
2,0#F,F,F,F,NULL
3,0#F,F,F,F,NULL
4,0#F,F,F,F,NULL
5,0#F,F,F,F,NULL
6,0#F,F,F,F,NULL
7,0#F,F,F,F,NULL
8,0#F,F,F,F,NULL
9,0#F,F,F,F,NULL
10,0#F,F,F,F,NULL
11,0#F,F,F,F,NULL
0,1#F,F,F,F,NULL
1,1#F,T,F,F,NULL
2,1#F,T,F,F,NULL
3,1#F,T,F,F,NULL
4,1#T,F,F,F,NULL
5,1#F,T,F,F,NULL
6,1#T,F,F,F,NULL
7,1#T,F,F,F,NULL
8,1#T,F,F,F,NULL
9,1#T,F,F,F,NULL
10,1#T,F,F,F,NULL
11,1#F,F,F,F,NULL
0,2#F,F,F,F,NULL
1,2#T,F,F,F,NULL
2,2#T,F,F,F,NULL
3,2#T,F,F,F,NULL
4,2#T,F,F,F,NULL
5,2#F,T,F,F,NULL
6,2#T,F,F,F,NULL
7,2#T,F,F,F,NULL
8,2#T,F,F,F,NULL
9,2#T,F,F,F,NULL
10,2#T,F,T,F,NULL
11,2#F,F,F,F,NULL
0,3#F,F,F,F,NULL
1,3#T,F,F,F,NULL
2,3#T,F,F,F,NULL
3,3#T,F,F,F,NULL
4,3#T,F,F,F,NULL
5,3#F,T,F,F,NULL
6,3#T,F,F,F,NULL
7,3#T,F,F,F,NULL
8,3#T,F,F,F,NULL
9,3#T,F,F,F,NULL
10,3#T,F,F,F,NULL
11,3#F,F,F,F,NULL
0,4#F,F,F,F,NULL
1,4#F,T,F,F,NULL
2,4#F,T,F,F,NULL
3,4#F,T,T,T,1x2
4,4#F,T,F,F,NULL
5,4#F,T,F,F,NULL
6,4#T,F,F,F,NULL
7,4#T,F,F,F,NULL
8,4#T,F,F,F,NULL
9,4#T,F,F,F,NULL
10,4#T,F,F,F,NULL
11,4#F,F,F,F,NULL
0,5#F,F,F,F,NULL
1,5#T,F,F,F,NULL
2,5#T,F,F,F,NULL
3,5#T,F,F,F,NULL
4,5#T,F,F,F,NULL
5,5#T,F,F,F,NULL
6,5#T,F,F,F,NULL
7,5#T,F,F,F,NULL
8,5#T,F,F,F,NULL
9,5#T,F,F,F,NULL
10,5#T,F,F,F,NULL
11,5#F,F,F,F,NULL
0,6#F,F,F,F,NULL
1,6#T,F,F,F,NULL
2,6#T,F,F,F,NULL
3,6#T,F,F,F,NULL
4,6#T,F,F,F,NULL
5,6#T,F,F,F,NULL
6,6#T,F,F,F,NULL
7,6#T,F,F,F,NULL
8,6#T,F,F,F,NULL
9,6#T,F,F,F,NULL
10,6#T,F,F,F,NULL
11,6#F,F,F,F,NULL
0,7#F,F,F,F,NULL
1,7#T,F,F,F,NULL
2,7#T,F,F,F,NULL
3,7#T,F,F,F,NULL
4,7#T,F,F,F,NULL
5,7#T,F,F,F,NULL
6,7#T,F,F,F,NULL
7,7#T,F,F,F,NULL
8,7#F,T,F,F,NULL
9,7#F,T,F,F,NULL
10,7#T,F,F,F,NULL
11,7#F,F,F,F,NULL
0,8#F,F,F,F,NULL
1,8#T,F,F,F,NULL
2,8#T,F,F,F,NULL
3,8#T,F,F,F,NULL
4,8#T,F,F,F,NULL
5,8#T,F,F,F,NULL
6,8#T,F,F,F,NULL
7,8#T,F,F,F,NULL
8,8#T,F,F,F,NULL
9,8#T,F,F,F,NULL
10,8#T,F,F,F,NULL
11,8#F,F,F,F,NULL
0,9#F,F,F,F,NULL
1,9#T,F,F,F,NULL
2,9#T,F,F,F,NULL
3,9#T,F,F,F,NULL
4,9#T,F,F,F,NULL
5,9#T,F,F,F,NULL
6,9#T,F,F,F,NULL
7,9#T,F,F,F,NULL
8,9#T,F,F,F,NULL
9,9#T,F,F,F,NULL
10,9#T,F,F,F,NULL
11,9#F,F,F,F,NULL
0,10#F,F,F,F,NULL
1,10#F,F,F,F,NULL
2,10#F,F,F,F,NULL
3,10#F,F,F,F,NULL
4,10#F,F,F,F,NULL
5,10#F,F,F,F,NULL
6,10#F,F,F,F,NULL
7,10#F,F,T,T,1x3
8,10#F,F,F,F,NULL
9,10#F,F,F,F,NULL
10,10#F,F,F,F,NULL
11,10#F,F,F,F,NULL
0,11#F,F,F,F,NULL
1,11#F,F,F,F,NULL
2,11#F,F,F,F,NULL
3,11#F,F,F,F,NULL
4,11#F,F,F,F,NULL
5,11#F,F,F,F,NULL
6,11#F,F,F,F,NULL
7,11#F,F,F,F,NULL
8,11#F,F,F,F,NULL
9,11#F,F,F,F,NULL
10,11#F,F,F,F,NULL
11,11#F,F,F,F,NULL
